┏━━━━━━━━━━━━━━━━━━━━━━━━━━━━━━━━━━━┓***┏━━━━━┓
┃                               ┏━━┓┃   ┃     ┃
┃        ┏━━━━━━━━━━━━┓         ┃  ┃┃   ┃     ┃
┃        ┃            ┃   ┏━━━━━┛  ┗┛   ┃     ┃
┃        ┃  ┏━━━━━━┓  ┃   ┃             ┃     ┃
┃        ┃  ┃      ┃  ┃   ┃  ┏━━┓  ┏━━━━┛     ┃
┃      ┏━┛  ┗━┓    ┃  ┗━━━┛  ┃  ┃ O┃          ┃
┃      ┃   ⭘  ┃    ┃         ┃  ┗━━┛          ┃
┃      ┗━┓  ┏━┛    ┗━━━━━━━━━┛                ┃
┃        ┃  ┗━━━━━━━━━━━━━━━┓                 ┃
┃        ┃                  ┃                 ┃
┃        ┗━━━━━━━━━━━━┓     ┃                 ┃
┃                  ┏━━┛     ┗━━┓              ┃
┃                  ┃ ⭘         ┃              ┃
┃                  ┗━━┓     ┏━━┛              ┃
┃                  ┏━━┛     ┗━━┓              ┃
┃                  ┃          ⭘┃              ┃
┃                  ┗━━┓     ┏━━┛              ┃
┃                     ┃     ┃                 ┃
┃                  ┏━━┛     ┗━━┓              ┃
┃                  ┃     ⭘     ┃              ┃
┃                  ┗━━┓     ┏━━┛              ┃
┃                     ┃     ┃                 ┃
┃                     ┃  @  ┃                 ┃
┗━━━━━━━━━━━━━━━━━━━━━┛^^^^^┗━━━━━━━━━━━━━━━━━┛