┏━━━━━━━━━━━━━━━━━━━━━━━━━━━━━━━━━━━┓***┏━━━━━┓
┃                               ┏━━┓┃   ┃     ┃
┃        ┏━━━━━━━━━━━━┓         ┃  ┃┃   ┃     ┃
┃        ┃            ┃   ┏━━━━━┛  ┗┛   ┃     ┃
┃        ┃  ┏━━━━━━┓  ┃   ┃             ┃     ┃
┃        ┃  ┃      ┃  ┃   ┃  ┏━━┓  ┏━━━━┛     ┃
┃      ┏━┛  ┗━┓    ┃  ┗━━━┛  ┃  ┃  ┃          ┃
┃      ┃    O ┃    ┃         ┃  ┗━━┛          ┃
┃      ┗━┓  ┏━┛    ┗━━━━━━━━━┛                ┃
┃        ┃  ┗━━━━━━━━━━━━━━━┓                 ┃
┃        ┃                  ┃                 ┃
┃        ┗━━━━━━━━━━━━┓     ┃                 ┃
┃                  ┏━━┛     ┗━━┓              ┃
┃                  ┃          ⭘┃              ┃
┃                  ┗━━┓     ┏━━┛              ┃
┃                     ┃     ┃                 ┃
┃                     ┃     ┃                 ┃
┃                     ┃     ┃                 ┃
┃                     ┃     ┃                 ┃
┃                     ┃     ┃                 ┃
┃                     ┃     ┃                 ┃
┃                     ┃  @  ┃                 ┃
┗━━━━━━━━━━━━━━━━━━━━━┛^^^^^┗━━━━━━━━━━━━━━━━━┛